11111111111111111111111111111111111111111
10000000000000000000000000000C00000000001
10000000000000000000000000001110001100001
10000000000000000000000000000000001100001
111110000000000000000000000000000000C0001
10000000000000000000000000000000000000001
10001111000000000000000000001000000000001
10000000000000000010100000000000000000001
11111000000000000010100000000000000000001
10000000000000001110111000000000000000001
1C00000000000000000P000000000000000000001
10000000000000001110111000000000000000001
10000000000000000010100000000000000000001
1000000000000000001011111110C000000000001
10000000000000000000010000110000000000001
10000000000000000000010110011000000000001
10000000000000000000010011001000000000001
100000000000000000000110011E1000000000001
10000000000000000000001101111000000000001
10000000000000000000000100000000000000001
11111111111111111111111111111111111111111
