1111111111111111
1Ee0P00000000001
1111111111110111
1e00000000000001
1011111111111111
10000000000000w1
1111111111110111
1C00000000000001
1111111111111111
