111111111111111111
1P0000000000000001
100000000000000001
10000000L000000001
10100000000R000001
100000000000000001
100L00000000000001
10000000U000000CE1
111111111111111111
