111111111111111111
1P0000000000000001
100000000000000001
10000000w000000001
10100000000e000001
100000000000000001
100w00000000000001
10000000n000000CE1
111111111111111111
