11111111111
10001000101
10101010101
10101010101
10101010101
101010101C1
1E101010101
101P0010001
11111111111
