111111111111111111
1P0000000Cn0000001
100C00000000000001
1C0000000000000001
100000000000000001
100000000E00000001
10000000000000w001
1000000000000000C1
111111111111111111
