11111111111
1P0000000C1
100C0000001
1C000000001
100000n0001
100000000E1
11111111111
