11111111111111111
1P0000000000000C1
100C0000n00000001
1C000000000000001
100000000000000E1
10000000000000001
10000000000000001
10000000000000001
11111111111111111
