1111111111111111
1ERP000000000001
1111111111111011
1R00000000000001
1011111111111111
10000000000000L1
1111111111111011
1C00000000000001
1111111111111111
