111111111111111111
1P               1
1                1
1       L        1
1 1        R     1
1                1
1  L             1
1       U      CE1
111111111111111111
