1111111111
10000010C1
10100P1001
1C1E000001
1111111111
