1111111111
1000001001
10100P1001
1C1E000001
1111111111
