11111111111
100010001C1
10101010101
10101010101
10101010101
10101010101
1E101010101
1P100010001
11111111111
