111111111111111111111111111111111111
100000000000000000000000000000000001
100P0000000000000000000C000000000001
100000000000000000000000000000000001
100000000000000000000000000000000001
100000000000000000000000000000000001
100000000000000000000000000000E00001
111111111111111111111111111111111111
